8 8
00000000
00000G00
00b00000
00000000
000a0000
000000S0
0AB00000
W000000W