9 9
WWW000000
WWW000000
000000000
000000000
0000S0000
000000000
000000000
0000000G0
000000000