8 7
WWWWWWWW
00000000
0Aa000Bb
00000000
0Cc0S000
00000000
WWWWWWWW