8 7
WWWWWWWW
W000000W
W0W0000W
W000000W
W0W0WW0W
WS00000W
WWWWWWWW