9 8
WWWW000WW
000000000
0Aa000Bb0
000000000
0Cc0S0Dd0
000000000
0Ee000Ff0
000000000
W00000000