9 8
WWWW000WW
000000000
0Aa000Bb0
000000000
0Cc0S0000
000000000
000000000
000000000
W00000000