9 9
WWWW000WW
000000000
0A0a0B0b0
000000000
0000S0000
000000000
0C0c0D0d0
000000000
W00E0e000